1 10 20
 *  *  *##*# *##*#*
 #  ## #####     ###
o*$#* #*  * #*  *#*s
### ## s  s r# * l#
#*# * #*##*# *  *#*
##### *#*  ####*##
l*##* #*# *# * #*#* 
s#  #  #  *f  #  # #
 *  *  *##*# * s*#*  
 ###% # ## ##* #*## 
