2 10 20
 *  *  *##*# *##*#*
   ##   ##     *##
o* #* #*  * #*o  *#*
 ## ##  b  r# * l#
$*# * ####*# *  *#*
 #### *##  ####*##
l*#** #*# *# * #*#*# 
 #  #  #  *  #  # #
 *  *  *##*# *  *#*  
 ###  b# ## ##* #*## 
