1 10 20
 *  *  *##*# *##*#*
    ## #####     ###
  * #* #*  * #*  *#*
*### ##       # *  #
*#*# * #*##*# *  *#*
*##### *#*  ####*##
 *##* #*# *# * #*#* 
 #  #  #  *  #  # #*
 *  *  *##*# *  *#* 
 ###  # ## ##* #*## 
