1 9 19
###################
#p     ** *    *  #
# # # #*# # #*#*# #
#   *     ***  *  #
# # # # # #*# # #*#
#            **  *#
# # # # # # # # # #
#*  *      *  *   #
# # # # #*# # # #*#
#*    **  *       #
# #*# # # # # # #*#
###################

Meta data:
(Number or Level) (Rows) (Columns)

Tiles:
# - Wall
* - Bricks

Mobs:
p - Player