1 10 20
 *  *  *##*# *##*#*
 p  ## #####     ###
 * #* #*  * #*  *#* 
### ##       # *  #
#*# * #*##*# *  *#* 
##### *#*  ####*##  
 *##* #*# *# * #*#* 
 #  #  #  *  #  # #
 *  *  *##*# *  *#* 
 ###  # ## ##* #*## 


Meta data:
(Number or Level) (Rows) (Columns)

Tiles:
# - Wall
* - Bricks

Mobs:
p - Player