2 10 20
 *  *b *##*# *##*#*
   ## #####   b *##
o* #* #*  * #*  *#*
 ## ##  b  r# * l#
 *# * #*##*# *  *#*
 #### *#*  ####*##
l*#** #*# *# * #*#*# 
 # b#  # $*  #  # #
 *  *  *##*# *  *#*b 
 ###ob# ## ##* #*## 
