1 10 20
 *  *  *##*# *##*#*
 #  ## #####     ###
o*$#* #*  * #*  *#*
### ##      r# * l#
#*# * #*##*# *  *#*
##### *#*  ####*##
l*##* #*# *# * #*#* 
s#  #  #  *f  #  # #
 *  *  *##*# *  *#*  
 ###% # ## ##* #*## 

