1 10 20
 *#  *  *##*# *##*#*
    ## ##o## s   ###
  *#* #*  * #*  *#*
### ##  s    # * l#
#*# * #*#o*# *  *#*
##### *#*  ##o#*##
 *##* #*# *# * #*#* 
s#  # l# s*f  #  # #
 *% *  *##*# *   *#  
 ###    ## ##* #*##$ 

