2 10 20
 *  *b *##*# *##*#*
   ##   ##   b *##
o* #* #*  * #*o  *#*
 ## ##  b  r# * l#
$*# * ####*# *  *#*
 #### *##  ####*##
l*#** #*# *# * #*#*# 
 # b#  #  *  #  # #
 *  *  *##*# *  *#*b 
 ###  b# ## ##* #*## 
