1 10 20
 *#  *  *##*# *##*#*
    ## ##### s   ###
  *#* #*  * #*  *#*
### ##  s    # * l#
#*# * #*##*# *  *#*
##### *#*  ####*##
 *##* #*# *# * #*#* 
s#  # l# s*f  #  # #
 *% *  *##*# *   *#  
 ###    ## ##* #*##$ 

